index=a
size=9*9
map=
WWWWWWWWW
W       W
W  R    W
W       W
W   M   W
W    R  W
W a     W
W     a W
WWWWWWWWW

index=aa
size=3*3
map=
W W
W W
WWW